WWWWWWWWWW
W        W
W   S    W
W    B   W
W        W
WWWWWWWWWW
