WWWWWWWWWW
WYYYYY  YW
W        W
WYY Y YYYW
WS CXXb  W
WYYY  WW W
W        W
W      B W
W       AW
WWWWWWWWWW