WWWWWWWWWW
W     bX W
WWWW WW  W
W        W
W      C W
W     TBTW
W   XXXT W
W   XSX  W
W T XXX  W
WWWWWWWWWW