WWWWWWWWWW
W    A   W
W        W
W        W
W    Y   W
W    d
W  S     W
W        W
W     B  W
WWWWWWWWWW