WWWWWWWWWW
WS     A W
WWWW   W W
W  WWWWW W
W      T W
W
W T      W
W WWWWWXWW
W d   B  W
WWWWWWWWWW
