WWWWWWWWWW
WB       W
WWWWXWWW W
WA       W
W HWWWWWWW
W        
WS       W
WXWWWWWWWW
W        W
WWWWWWWWWW