WWWWWWWWWW
WS b     W
WWWWWW   W
W     Y  W
WXXX     W
WTV   V  W
W   TT  WW
W  T   W
W BT   TWW
WWWWWWWWWW