WWWWWWWWWW
W  B     W
W  YYYY  W
W        W
W    WWXWW
W   YW
W  S W   W
W        W
W    Y   W
WWWWWWWWWW