WWWWWWWWWW
WSb      W
WWWWW WW W
W        W
W        W
W        W
W   bH   W
W   VBVV W
W    H   W
WWWWWWWWWW