WWWWWWWWWW
WS b     W
WWWWWW   W
W b X Y  W
WXXXX    W
WTV   V  W
W   TT  WW
W  T   W
W BT   TWW
WWWWWWWWWW