WWWWWWWWWW
WS b     W
WWWWWW   W
W     Y  W
W        W
W        W
W       WW
W      W
W B     WW
WWWWWWWWWW