WWWWWWWWWW
W  B     W
W  YYYY  W
W   b    W
W    WWXWW
W   YW
W  S W   W
W        W
W   C  T W
WWWWWWWWWW