WWWWWWWWWW
W        W
WBRAR    W
WXX XXXXXW
W        W
W      V 
W        W
W C  WWWWW
W TST    W
WWWWWWWWWW
