WWWWWWWWWW
W  B     W
W     T  W
W   b    W
W     R  W
W     
W  S  A  W
W        W
W   C  T W
WWWWWWWWWW