WWWWWWWWWW
W  B     W
W  YYYY  W
W   b    W
W    WWXWW
W   YW
W  S W   W
W    C   W
W      T W
WWWWWWWWWW