WWWWWWWWWW
WB     A W
WWWWWWWW W
W   CSVW W
WYXYYYV YW
W   R    W
W       WW
W  YYY  R
W      HHW 
WWWWWWWWWW