WWWWWWWWWW
WB       W
WWWWXWWW W
W        W
W HWWWWWWW
W        
W        W
WXWWWWWWWW
W      S W
WWWWWWWWWW