WWWWWWWWWW
WB     A W
WWWWWWWW W
W   CSVW W
WYXYYYV YW
W   R    W
W        W
W      R
W        W
WWWWWWWWWW